gadget_bg	gadget_bg
button_bg_off	button_off
button_bg_offroll	button_offroll
button_bg_on	button_on
button_bg_onroll	button_onroll
button_bg_disable	button_disable
button_bordera	button_bordera
button_borderb	button_borderb
button_text_off	buttontext_off
button_text_offroll	buttontext_offroll
button_text_on	buttontext_on
button_text_onroll	buttontext_onroll
button_text_disable	buttontext_disable
label_text	buttontext_off
label_text_disable	buttontext_disable
field_text_on	buttontext_off
field_text_onroll	buttontext_off
field_text_disable	buttontext_disable
field_bg_on	field_on
field_bg_onroll	field_onroll
field_bg_disable	field_disable
field_border	gadget_bordera
